F.F.T..............F
...........F...T....
L....F..............
..........T.........
.....T......L....FF.
....................
........F....W.FF...
....F....FF..A......
.........T..........
........T..........T
.....FF.............
.....FF.....T.......
...T................
.....F..F.......T...
....T.....F...T....
...........F........
.........T..........
.....F......T..F....
T....T............T.
....................